11111111111111111
11PCC10BC00C0B0C1
1B0011B01B0111101
11BC00C1110CB0B01
1C001B00C0000C0E1
11111111111111111
