11111111111
1C0111C0E11
110B1B0B0C1
1B0P00C1011
11111111111