11111111111111111
1P10C0B111C00B0C1
10C0BC0C000B01001
10B100101111C0CB1
1C01BC10CB01B00E1
1B01111011110C0B1
1C000B1C100B010C1
10B0C01B1111C0B11
11111111111111111
