11111111111
1C0101C0E11
110D1D0D0C1
1D0P00C1011
11111111111
