1111111111111111
10001000000100E1
1000100000010001
1000111110000001
1P00000000001111
1000000000000001
1001111111000001
1001000000000001
1111111111111111