11111111111
100C0100CE1
11111100001
1111111P001
11111111111
