11111111
1P0000C1
100C1111
10000FE1
11111111
