1111111111111111
10C010C000010001
1000100000010001
1000111110000001
1P00000000001111
1000000C00000001
1001111111000001
100100C0000000C1
1111111111111111