1111111111111111111
10C010C0001000E0001
1000100000100000001
1000111100000000001
1P00000000001111111
100100C00000000C001
1001001111111111111
10C1000000000C00001
1111111111111111111
