11111111111111111
10C010C0111C00E01
11011010011010011
10001111010000111
1C1000100C0101111
101000C01000000C1
10110011100011111
1PC1000C00100C011
11111111111111111