11111
10CE1
11101
10001
10C11
1C111
10101
1P0C1
11111