1111111111111
10C010C000E01
1000000000001
1P00000011111
10C100000C001
1111111111111