11111111111111111
10C010C0001000E01
10001000001000001
10001111000000001
1P000000000011111
100100C00000000C1
10010011111111111
10C1000000000C001
11111111111111111
